1111111111111111111111111111111111111
1001000P00001111100000000000000000001
1001111011111001110000000000000000001
1000110000001000C10000000001111000001
1000000000001001110011110000000000011
1000000000000000000000000000000000001
100000000C0000C00000C0000000000000001
1000000000000000000001111000000000011
1000011111111111100000000000011111111
1000000000000000000001110000000000001
1111100000000000000010000000011100001
111111111100000000000000011100E100001
1111111111111111111111111111111111111