NO ./textures/Untitled.xpm
SO ./textures/Untitled.xpm
WE ./textures/Untitled.xpm
EA ./textures/Untitled.xpm


F 0,0,0
C 255,255,255

1111111111111111111111111111111111111
1S00000000001000000000000000000000001
1011111001110111111111111111011111101
1000000010000000000000000010000000001
1011111110111111111111111111101111101
1000000000000000000000000000000000001
1011111111100000000000000000111111101
1000000000100000000000000000100000001
1011111101100000000000000000111111111
1000000100000000000000000000000000001
1111101111111110111111111111111011101
1000000000000000000000000000010000001
1011111111111111111111111111111111101
1000000000000000000000000000000000001
1011111011111111111111111111111011111
1000000010000000000000000000010000001
1111111010111111111111111111011111111
1000000010100000000000000000000000001
1000000000100000000000000000000000001
1000000000100000000000000000000000001
1000000000100000000000000000000000001
1000000000000000000000000000000000001
1000000000100000000000000000000000001
1000000000100000000000000000000000001
1000000000100000000000000000000000001
1000000000100000000000000000000000001
1111111111111111111111111111111111111
